Date,Label,OneWeekBefore,TwoWeekBefore,OneWeekDelta,TwoWeekDelta
1/17/1997,32,323,347,-24,0
1/24/1997,-4,355,323,32,-24
1/31/1997,-26,351,355,-4,32
2/7/1997,-16,325,351,-26,-4
2/14/1997,0,309,325,-16,-26
2/21/1997,7,309,309,0,-16
2/28/1997,-6,316,309,7,0
3/7/1997,-3,310,316,-6,7
3/14/1997,5,307,310,-3,-6
3/21/1997,-2,312,307,5,-3
3/28/1997,4,310,312,-2,5
4/4/1997,0,314,310,4,-2
4/11/1997,18,314,314,0,4
4/18/1997,-8,332,314,18,0
4/25/1997,23,324,332,-8,18
5/2/1997,0,347,324,23,-8
5/9/1997,-28,347,347,0,23
5/16/1997,3,319,347,-28,0
5/23/1997,0,322,319,3,-28
5/30/1997,16,322,322,0,3
6/6/1997,1,338,322,16,0
6/13/1997,8,339,338,1,16
6/20/1997,-15,347,339,8,1
6/27/1997,5,332,347,-15,8
7/4/1997,40,337,332,5,-15
7/11/1997,-28,377,337,40,5
7/18/1997,-50,349,377,-28,40
7/25/1997,-22,299,349,-50,-28
8/1/1997,23,277,299,-22,-50
8/8/1997,16,300,277,23,-22
8/15/1997,21,316,300,16,23
8/22/1997,-10,337,316,21,16
8/29/1997,2,327,337,-10,21
9/5/1997,-11,329,327,2,-10
9/12/1997,-12,318,329,-11,2
9/19/1997,0,306,318,-12,-11
9/26/1997,2,306,306,0,-12
10/3/1997,-4,308,306,2,0
10/10/1997,2,304,308,-4,2
10/17/1997,9,306,304,2,-4
10/24/1997,-18,315,306,9,2
10/31/1997,18,297,315,-18,9
11/7/1997,-5,315,297,18,-18
11/14/1997,23,310,315,-5,18
11/21/1997,-30,333,310,23,-5
11/28/1997,0,303,333,-30,23
12/5/1997,8,303,303,0,-30
12/12/1997,8,311,303,8,0
12/19/1997,-12,319,311,8,8
12/26/1997,11,307,319,-12,8
1/2/1998,16,318,307,11,-12
1/9/1998,1,334,318,16,11
1/16/1998,-9,335,334,1,16
1/23/1998,-26,326,335,-9,1
1/30/1998,3,300,326,-26,-9
2/6/1998,0,303,300,3,-26
2/13/1998,-2,303,303,0,3
2/20/1998,19,301,303,-2,0
2/27/1998,-16,320,301,19,-2
3/6/1998,-6,304,320,-16,19
3/13/1998,10,298,304,-6,-16
3/20/1998,5,308,298,10,-6
3/27/1998,-4,313,308,5,10
4/3/1998,-1,309,313,-4,5
4/10/1998,-19,308,309,-1,-4
4/17/1998,28,289,308,-19,-1
4/24/1998,2,317,289,28,-19
5/1/1998,-11,319,317,2,28
5/8/1998,-1,308,319,-11,2
5/15/1998,6,307,308,-1,-11
5/22/1998,-1,313,307,6,-1
5/29/1998,27,312,313,-1,6
6/5/1998,-24,339,312,27,-1
6/12/1998,12,315,339,-24,27
6/19/1998,37,327,315,12,-24
6/26/1998,26,364,327,37,12
7/3/1998,2,390,364,26,37
7/10/1998,-56,392,390,2,26
7/17/1998,-21,336,392,-56,2
7/24/1998,-11,315,336,-21,-56
7/31/1998,3,304,315,-11,-21
8/7/1998,-6,307,304,3,-11
8/14/1998,0,301,307,-6,3
8/21/1998,-4,301,301,0,-6
8/28/1998,5,297,301,-4,0
9/4/1998,10,302,297,5,-4
9/11/1998,-13,312,302,10,5
9/18/1998,-7,299,312,-13,10
9/25/1998,-3,292,299,-7,-13
10/2/1998,11,289,292,-3,-7
10/9/1998,3,300,289,11,-3
10/16/1998,15,303,300,3,11
10/23/1998,-17,318,303,15,3
10/30/1998,11,301,318,-17,15
11/6/1998,9,312,301,11,-17
11/13/1998,11,321,312,9,11
11/20/1998,-32,332,321,11,9
11/27/1998,13,300,332,-32,11
12/4/1998,1,313,300,13,-32
12/11/1998,-18,314,313,1,13
12/18/1998,-9,296,314,-18,1
12/25/1998,81,287,296,-9,-18
1/1/1999,-18,368,287,81,-9
1/8/1999,2,350,368,-18,81
1/15/1999,-6,352,350,2,-18
1/22/1999,-45,346,352,-6,2
1/29/1999,-9,301,346,-45,-6
2/5/1999,-11,292,301,-9,-45
2/12/1999,7,281,292,-11,-9
2/19/1999,5,288,281,7,-11
2/26/1999,-7,293,288,5,7
3/5/1999,3,286,293,-7,5
3/12/1999,9,289,286,3,-7
3/19/1999,-9,298,289,9,3
3/26/1999,0,289,298,-9,9
4/2/1999,10,289,289,0,-9
4/9/1999,17,299,289,10,0
4/16/1999,-2,316,299,17,10
4/23/1999,-20,314,316,-2,17
4/30/1999,7,294,314,-20,-2
5/7/1999,2,301,294,7,-20
5/14/1999,-4,303,301,2,7
5/21/1999,1,299,303,-4,2
5/28/1999,5,300,299,1,-4
6/4/1999,18,305,300,5,1
6/11/1999,-26,323,305,18,5
6/18/1999,5,297,323,-26,18
6/25/1999,-3,302,297,5,-26
7/2/1999,-5,299,302,-3,5
7/9/1999,16,294,299,-5,-3
7/16/1999,3,310,294,16,-5
7/23/1999,-38,313,310,3,16
7/30/1999,4,275,313,-38,3
8/6/1999,5,279,275,4,-38
8/13/1999,3,284,279,5,4
8/20/1999,-4,287,284,3,5
8/27/1999,6,283,287,-4,3
9/3/1999,-3,289,283,6,-4
9/10/1999,2,286,289,-3,6
9/17/1999,-16,288,286,2,-3
9/24/1999,27,272,288,-16,2
10/1/1999,13,299,272,27,-16
10/8/1999,-27,312,299,13,27
10/15/1999,13,285,312,-27,13
10/22/1999,-20,298,285,13,-27
10/29/1999,10,278,298,-20,13
11/5/1999,-3,288,278,10,-20
11/12/1999,2,285,288,-3,10
11/19/1999,-13,287,285,2,-3
11/26/1999,17,274,287,-13,2
12/3/1999,2,291,274,17,-13
12/10/1999,-27,293,291,2,17
12/17/1999,15,266,293,-27,2
12/24/1999,-7,281,266,15,-27
12/31/1999,35,274,281,-7,15
1/7/2000,0,309,274,35,-7
1/14/2000,-37,309,309,0,35
1/21/2000,-6,272,309,-37,0
1/28/2000,8,266,272,-6,-37
2/4/2000,27,274,266,8,-6
2/11/2000,-18,301,274,27,8
2/18/2000,-5,283,301,-18,27
2/25/2000,-3,278,283,-5,-18
3/3/2000,5,275,278,-3,-5
3/10/2000,-18,280,275,5,-3
3/17/2000,4,262,280,-18,5
3/24/2000,0,266,262,4,-18
3/31/2000,-6,266,266,0,4
4/7/2000,4,260,266,-6,0
4/14/2000,-7,264,260,4,-6
4/21/2000,26,257,264,-7,4
4/28/2000,20,283,257,26,-7
5/5/2000,-6,303,283,20,26
5/12/2000,-21,297,303,-6,20
5/19/2000,8,276,297,-21,-6
5/26/2000,2,284,276,8,-21
6/2/2000,23,286,284,2,8
6/9/2000,-13,309,286,23,2
6/16/2000,6,296,309,-13,23
6/23/2000,4,302,296,6,-13
6/30/2000,-10,306,302,4,6
7/7/2000,23,296,306,-10,4
7/14/2000,-8,319,296,23,-10
7/21/2000,-39,311,319,-8,23
7/28/2000,4,272,311,-39,-8
8/4/2000,17,276,272,4,-39
8/11/2000,20,293,276,17,4
8/18/2000,1,313,293,20,17
8/25/2000,4,314,313,1,20
9/1/2000,-2,318,314,4,1
9/8/2000,8,316,318,-2,4
9/15/2000,-16,324,316,8,-2
9/22/2000,-21,308,324,-16,8
9/29/2000,12,287,308,-21,-16
10/6/2000,7,299,287,12,-21
10/13/2000,1,306,299,7,12
10/20/2000,-2,307,306,1,7
10/27/2000,3,305,307,-2,1
11/3/2000,36,308,305,3,-2
11/10/2000,-18,344,308,36,3
11/17/2000,10,326,344,-18,36
11/24/2000,22,336,326,10,-18
12/1/2000,-6,358,336,22,10
12/8/2000,-32,352,358,-6,22
12/15/2000,34,320,352,-32,-6
12/22/2000,-21,354,320,34,-32
12/29/2000,42,333,354,-21,34
1/5/2001,-30,375,333,42,-21
1/12/2001,-39,345,375,-30,42
1/19/2001,10,306,345,-39,-30
1/26/2001,30,316,306,10,-39
2/2/2001,15,346,316,30,10
2/9/2001,-9,361,346,15,30
2/16/2001,-4,352,361,-9,15
2/23/2001,24,348,352,-4,-9
3/2/2001,-2,372,348,24,-4
3/9/2001,5,370,372,-2,24
3/16/2001,4,375,370,5,-2
3/23/2001,-17,379,375,4,5
3/30/2001,21,362,379,-17,4
4/6/2001,9,383,362,21,-17
4/13/2001,-7,392,383,9,21
4/20/2001,23,385,392,-7,9
4/27/2001,13,408,385,23,-7
5/4/2001,-37,421,408,13,23
5/11/2001,-4,384,421,-37,13
5/18/2001,27,380,384,-4,-37
5/25/2001,12,407,380,27,-4
6/1/2001,13,419,407,12,27
6/8/2001,-4,432,419,13,12
6/15/2001,-28,428,432,-4,13
6/22/2001,-12,400,428,-28,-4
6/29/2001,11,388,400,-12,-28
7/6/2001,46,399,388,11,-12
7/13/2001,-31,445,399,46,11
7/20/2001,-48,414,445,-31,46
7/27/2001,-20,366,414,-48,-31
8/3/2001,39,346,366,-20,-48
8/10/2001,-5,385,346,39,-20
8/17/2001,13,380,385,-5,39
8/24/2001,6,393,380,13,-5
8/31/2001,3,399,393,6,13
9/7/2001,29,402,399,3,6
9/14/2001,-44,431,402,29,3
9/21/2001,63,387,431,-44,29
9/28/2001,78,450,387,63,-44
10/5/2001,-60,528,450,78,63
10/12/2001,22,468,528,-60,78
10/19/2001,14,490,468,22,-60
10/26/2001,-5,504,490,14,22
11/2/2001,-49,499,504,-5,14
11/9/2001,-6,450,499,-49,-5
11/16/2001,-17,444,450,-6,-49
11/23/2001,61,427,444,-17,-6
11/30/2001,-13,488,427,61,-17
12/7/2001,-81,475,488,-13,61
12/14/2001,-10,394,475,-81,-13
12/21/2001,8,384,394,-10,-81
12/28/2001,55,392,384,8,-10
1/4/2002,-52,447,392,55,8
1/11/2002,-11,395,447,-52,55
1/18/2002,-8,384,395,-11,-52
1/25/2002,14,376,384,-8,-11
2/1/2002,-14,390,376,14,-8
2/8/2002,-3,376,390,-14,14
2/15/2002,10,373,376,-3,-14
2/22/2002,-5,383,373,10,-3
3/1/2002,-2,378,383,-5,10
3/8/2002,1,376,378,-2,-5
3/15/2002,-6,377,376,1,-2
3/22/2002,23,371,377,-6,1
3/29/2002,66,394,371,23,-6
4/5/2002,-22,460,394,66,23
4/12/2002,7,438,460,-22,66
4/19/2002,-24,445,438,7,-22
4/26/2002,-3,421,445,-24,7
5/3/2002,-7,418,421,-3,-24
5/10/2002,7,411,418,-7,-3
5/17/2002,-2,418,411,7,-7
5/24/2002,-6,416,418,-2,7
5/31/2002,-27,410,416,-6,-2
6/7/2002,7,383,410,-27,-6
6/14/2002,3,390,383,7,-27
6/21/2002,-5,393,390,3,7
6/28/2002,-6,388,393,-5,3
7/5/2002,21,382,388,-6,-5
7/12/2002,-24,403,382,21,-6
7/19/2002,-17,379,403,-24,21
7/26/2002,25,362,379,-17,-24
8/2/2002,-11,387,362,25,-17
8/9/2002,12,376,387,-11,25
8/16/2002,1,388,376,12,-11
8/23/2002,14,389,388,1,12
8/30/2002,0,403,389,14,1
9/6/2002,23,403,403,0,14
9/13/2002,-2,426,403,23,0
9/20/2002,-18,424,426,-2,23
9/27/2002,11,406,424,-18,-2
10/4/2002,-33,417,406,11,-18
10/11/2002,27,384,417,-33,11
10/18/2002,-22,411,384,27,-33
10/25/2002,21,389,411,-22,27
11/1/2002,-20,410,389,21,-22
11/8/2002,-2,390,410,-20,21
11/15/2002,-12,388,390,-2,-20
11/22/2002,-12,376,388,-12,-2
11/29/2002,-9,364,376,-12,-12
12/6/2002,86,355,364,-9,-12
12/13/2002,-8,441,355,86,-9
12/20/2002,-55,433,441,-8,86
12/27/2002,25,378,433,-55,-8
1/3/2003,-14,403,378,25,-55
1/10/2003,-29,389,403,-14,25
1/17/2003,21,360,389,-29,-14
1/24/2003,16,381,360,21,-29
1/31/2003,-6,397,381,16,21
2/7/2003,-14,391,397,-6,16
2/14/2003,25,377,391,-14,-6
2/21/2003,15,402,377,25,-14
2/28/2003,13,417,402,15,25
3/7/2003,-10,430,417,13,15
3/14/2003,1,420,430,-10,13
3/21/2003,-19,421,420,1,-10
3/28/2003,43,402,421,-19,1
4/4/2003,-40,445,402,43,-19
4/11/2003,37,405,445,-40,43
4/18/2003,13,442,405,37,-40
4/25/2003,-7,455,442,13,37
5/2/2003,-23,448,455,-7,13
5/9/2003,-8,425,448,-23,-7
5/16/2003,11,417,425,-8,-23
5/23/2003,-4,428,417,11,-8
5/30/2003,18,424,428,-4,11
6/6/2003,-12,442,424,18,-4
6/13/2003,-9,430,442,-12,18
6/20/2003,-17,421,430,-9,-12
6/27/2003,26,404,421,-17,-9
7/4/2003,9,430,404,26,-17
7/11/2003,-27,439,430,9,26
7/18/2003,-26,412,439,-27,9
7/25/2003,2,386,412,-26,-27
8/1/2003,2,388,386,2,-26
8/8/2003,8,390,388,2,2
8/15/2003,-12,398,390,8,2
8/22/2003,8,386,398,-12,8
8/29/2003,19,394,386,8,-12
9/5/2003,9,413,394,19,8
9/12/2003,-23,422,413,9,19
9/19/2003,-18,399,422,-23,9
9/26/2003,18,381,399,-18,-23
10/3/2003,-17,399,381,18,-18
10/10/2003,2,382,399,-17,18
10/17/2003,2,384,382,2,-17
10/24/2003,0,386,384,2,2
10/31/2003,-38,386,386,0,2
11/7/2003,18,348,386,-38,0
11/14/2003,-11,366,348,18,-38
11/21/2003,-4,355,366,-11,18
11/28/2003,14,351,355,-4,-11
12/5/2003,13,365,351,14,-4
12/12/2003,-25,378,365,13,14
12/19/2003,0,353,378,-25,13
12/26/2003,-14,353,353,0,-25
1/2/2004,14,339,353,-14,0
1/9/2004,-10,353,339,14,-14
1/16/2004,-2,343,353,-10,14
1/23/2004,1,341,343,-2,-10
1/30/2004,14,342,341,1,-2
2/6/2004,7,356,342,14,1
2/13/2004,-19,363,356,7,14
2/20/2004,6,344,363,-19,7
2/27/2004,-5,350,344,6,-19
3/5/2004,-4,345,350,-5,6
3/12/2004,-5,341,345,-4,-5
3/19/2004,3,336,341,-5,-4
3/26/2004,3,339,336,3,-5
4/2/2004,-14,342,339,3,3
4/9/2004,32,328,342,-14,3
4/16/2004,-7,360,328,32,-14
4/23/2004,-15,353,360,-7,32
4/30/2004,-23,338,353,-15,-7
5/7/2004,16,315,338,-23,-15
5/14/2004,14,331,315,16,-23
5/21/2004,-1,345,331,14,16
5/28/2004,-5,344,345,-1,14
6/4/2004,13,339,344,-5,-1
6/11/2004,-16,352,339,13,-5
6/18/2004,13,336,352,-16,13
6/25/2004,2,349,336,13,-16
7/2/2004,-41,351,349,2,13
7/9/2004,39,310,351,-41,2
7/16/2004,-10,349,310,39,-41
7/23/2004,6,339,349,-10,39
7/30/2004,-9,345,339,6,-10
8/6/2004,-3,336,345,-9,6
8/13/2004,-2,333,336,-3,-9
8/20/2004,12,331,333,-2,-3
8/27/2004,19,343,331,12,-2
9/3/2004,-43,362,343,19,12
9/10/2004,14,319,362,-43,19
9/17/2004,17,333,319,14,-43
9/24/2004,19,350,333,17,14
10/1/2004,-34,369,350,19,17
10/8/2004,17,335,369,-34,19
10/15/2004,-23,352,335,17,-34
10/22/2004,21,329,352,-23,17
10/29/2004,-18,350,329,21,-23
11/5/2004,1,332,350,-18,21
11/12/2004,1,333,332,1,-18
11/19/2004,-11,334,333,1,1
11/26/2004,26,323,334,-11,1
12/3/2004,8,349,323,26,-11
12/10/2004,-40,357,349,8,26
12/17/2004,16,317,357,-40,8
12/24/2004,-7,333,317,16,-40
12/31/2004,38,326,333,-7,16
1/7/2005,3,364,326,38,-7
1/14/2005,-48,367,364,3,38
1/21/2005,6,319,367,-48,3
1/28/2005,-9,325,319,6,-48
2/4/2005,-13,316,325,-9,6
2/11/2005,-1,303,316,-13,-9
2/18/2005,10,302,303,-1,-13
2/25/2005,-2,312,302,10,-1
3/4/2005,17,310,312,-2,10
3/11/2005,-9,327,310,17,-2
3/18/2005,6,318,327,-9,17
3/25/2005,26,324,318,6,-9
4/1/2005,-16,350,324,26,6
4/8/2005,-4,334,350,-16,26
4/15/2005,-34,330,334,-4,-16
4/22/2005,24,296,330,-34,-4
4/29/2005,13,320,296,24,-34
5/6/2005,7,333,320,13,24
5/13/2005,-19,340,333,7,13
5/20/2005,2,321,340,-19,7
5/27/2005,27,323,321,2,-19
6/3/2005,-20,350,323,27,2
6/10/2005,3,330,350,-20,27
6/17/2005,-19,333,330,3,-20
6/24/2005,-4,314,333,-19,3
7/1/2005,9,310,314,-4,-19
7/8/2005,17,319,310,9,-4
7/15/2005,-33,336,319,17,9
7/22/2005,7,303,336,-33,17
7/29/2005,2,310,303,7,-33
8/5/2005,-4,312,310,2,7
8/12/2005,8,308,312,-4,2
8/19/2005,-1,316,308,8,-4
8/26/2005,5,315,316,-1,8
9/2/2005,-1,320,315,5,-1
9/9/2005,79,319,320,-1,5
9/16/2005,34,398,319,79,-1
9/23/2005,-76,432,398,34,79
9/30/2005,34,356,432,-76,34
10/7/2005,-1,390,356,34,-76
10/14/2005,-34,389,390,-1,34
10/21/2005,-27,355,389,-34,-1
10/28/2005,-5,328,355,-27,-34
11/4/2005,3,323,328,-5,-27
11/11/2005,-23,326,323,3,-5
11/18/2005,32,303,326,-23,3
11/25/2005,-15,335,303,32,-23
12/2/2005,7,320,335,-15,32
12/9/2005,2,327,320,7,-15
12/16/2005,-11,329,327,2,7
12/23/2005,4,318,329,-11,2
12/30/2005,-31,322,318,4,-11
1/6/2006,18,291,322,-31,4
1/13/2006,-38,309,291,18,-31
1/20/2006,12,271,309,-38,18
1/27/2006,-10,283,271,12,-38
2/3/2006,4,273,283,-10,12
2/10/2006,20,277,273,4,-10
2/17/2006,-19,297,277,20,4
2/24/2006,16,278,297,-19,20
3/3/2006,9,294,278,16,-19
3/10/2006,6,303,294,9,16
3/17/2006,-7,309,303,6,9
3/24/2006,0,302,309,-7,6
3/31/2006,-3,302,302,0,-7
4/7/2006,14,299,302,-3,0
4/14/2006,-10,313,299,14,-3
4/21/2006,12,303,313,-10,14
4/28/2006,7,315,303,12,-10
5/5/2006,2,322,315,7,12
5/12/2006,43,324,322,2,7
5/19/2006,-38,367,324,43,2
5/26/2006,7,329,367,-38,43
6/2/2006,-34,336,329,7,-38
6/9/2006,-7,302,336,-34,7
6/16/2006,13,295,302,-7,-34
6/23/2006,5,308,295,13,-7
6/30/2006,0,313,308,5,13
7/7/2006,19,313,313,0,5
7/14/2006,-28,332,313,19,0
7/21/2006,-6,304,332,-28,19
7/28/2006,17,298,304,-6,-28
8/4/2006,4,315,298,17,-6
8/11/2006,-7,319,315,4,17
8/18/2006,1,312,319,-7,4
8/25/2006,3,313,312,1,-7
9/1/2006,-6,316,313,3,1
9/8/2006,-2,310,316,-6,3
9/15/2006,10,308,310,-2,-6
9/22/2006,-2,318,308,10,-2
9/29/2006,-14,316,318,-2,10
10/6/2006,6,302,316,-14,-2
10/13/2006,-9,308,302,6,-14
10/20/2006,9,299,308,-9,6
10/27/2006,19,308,299,9,-9
11/3/2006,-19,327,308,19,9
11/10/2006,0,308,327,-19,19
11/17/2006,13,308,308,0,-19
11/24/2006,36,321,308,13,0
12/1/2006,-33,357,321,36,13
12/8/2006,-20,324,357,-33,36
12/15/2006,11,304,324,-20,-33
12/22/2006,2,315,304,11,-20
12/29/2006,12,317,315,2,11
1/5/2007,-30,329,317,12,2
1/12/2007,-9,299,329,-30,12
1/19/2007,35,290,299,-9,-30
1/26/2007,-18,325,290,35,-9
2/2/2007,4,307,325,-18,35
2/9/2007,46,311,307,4,-18
2/16/2007,-25,357,311,46,4
2/23/2007,6,332,357,-25,46
3/2/2007,-10,338,332,6,-25
3/9/2007,-10,328,338,-10,6
3/16/2007,-2,318,328,-10,-10
3/23/2007,-8,316,318,-2,-10
3/30/2007,13,308,316,-8,-2
4/6/2007,21,321,308,13,-8
4/13/2007,-3,342,321,21,13
4/20/2007,-18,339,342,-3,21
4/27/2007,-16,321,339,-18,-3
5/4/2007,-8,305,321,-16,-18
5/11/2007,-4,297,305,-8,-16
5/18/2007,18,293,297,-4,-8
5/25/2007,-1,311,293,18,-4
6/1/2007,-1,310,311,-1,18
6/8/2007,2,309,310,-1,-1
6/15/2007,13,311,309,2,-1
6/22/2007,-11,324,311,13,2
6/29/2007,5,313,324,-11,13
7/6/2007,-10,318,313,5,-11
7/13/2007,-7,308,318,-10,5
7/20/2007,0,301,308,-7,-10
7/27/2007,6,301,301,0,-7
8/3/2007,9,307,301,6,0
8/10/2007,6,316,307,9,6
8/17/2007,0,322,316,6,9
8/24/2007,12,322,322,0,6
8/31/2007,-16,334,322,12,0
9/7/2007,1,318,334,-16,12
9/14/2007,-8,319,318,1,-16
9/21/2007,-13,311,319,-8,1
9/28/2007,19,298,311,-13,-8
10/5/2007,-9,317,298,19,-13
10/12/2007,29,308,317,-9,19
10/19/2007,-6,337,308,29,-9
10/26/2007,-4,331,337,-6,29
11/2/2007,-10,327,331,-4,-6
11/9/2007,22,317,327,-10,-4
11/16/2007,-9,339,317,22,-10
11/23/2007,22,330,339,-9,22
11/30/2007,-14,352,330,22,-9
12/7/2007,-5,338,352,-14,22
12/14/2007,13,333,338,-5,-14
12/21/2007,3,346,333,13,-5
12/28/2007,-13,349,346,3,13
1/4/2008,-14,336,349,-13,3
1/11/2008,-21,322,336,-14,-13
1/18/2008,0,301,322,-21,-14
1/25/2008,74,301,301,0,-21
2/1/2008,-19,375,301,74,0
2/8/2008,-8,356,375,-19,74
2/15/2008,1,348,356,-8,-19
2/22/2008,24,349,348,1,-8
2/29/2008,-22,373,349,24,1
3/7/2008,2,351,373,-22,24
3/14/2008,25,353,351,2,-22
3/21/2008,-12,378,353,25,2
3/28/2008,41,366,378,-12,25
4/4/2008,-50,407,366,41,-12
4/11/2008,15,357,407,-50,41
4/18/2008,-30,372,357,15,-50
4/25/2008,38,342,372,-30,15
5/2/2008,-15,380,342,38,-30
5/9/2008,6,365,380,-15,38
5/16/2008,-6,371,365,6,-15
5/23/2008,7,365,371,-6,6
5/30/2008,-15,372,365,7,-6
6/6/2008,27,357,372,-15,7
6/13/2008,-3,384,357,27,-15
6/20/2008,3,381,384,-3,27
6/27/2008,20,384,381,3,-3
7/4/2008,-58,404,384,20,3
7/11/2008,20,346,404,-58,20
7/18/2008,40,366,346,20,-58
7/25/2008,42,406,366,40,20
8/1/2008,7,448,406,42,40
8/8/2008,-5,455,448,7,42
8/15/2008,-18,450,455,-5,7
8/22/2008,-7,432,450,-18,-5
8/29/2008,19,425,432,-7,-18
9/5/2008,1,444,425,19,-7
9/12/2008,10,445,444,1,19
9/19/2008,38,455,445,10,1
9/26/2008,4,493,455,38,10
10/3/2008,-19,497,493,4,38
10/10/2008,-17,478,497,-19,4
10/17/2008,17,461,478,-17,-19
10/24/2008,1,478,461,17,-17
10/31/2008,2,479,478,1,17
11/7/2008,35,481,479,2,1
11/14/2008,26,516,481,35,2
11/21/2008,-13,542,516,26,35
11/28/2008,-20,529,542,-13,26
12/5/2008,64,509,529,-20,-13
12/12/2008,-19,573,509,64,-20
12/19/2008,32,554,573,-19,64
12/26/2008,-94,586,554,32,-19
1/2/2009,-25,492,586,-94,32
1/9/2009,57,467,492,-25,-94
1/16/2009,65,524,467,57,-25
1/23/2009,-1,589,524,65,57
1/30/2009,38,588,589,-1,65
2/6/2009,-3,626,588,38,-1
2/13/2009,4,623,626,-3,38
2/20/2009,40,627,623,4,-3
2/27/2009,-28,667,627,40,4
3/6/2009,15,639,667,-28,40
3/13/2009,-8,654,639,15,-28
3/20/2009,6,646,654,-8,15
3/27/2009,17,652,646,6,-8
4/3/2009,-15,669,652,17,6
4/10/2009,-44,654,669,-15,17
4/17/2009,30,610,654,-44,-15
4/24/2009,-9,640,610,30,-44
5/1/2009,-30,631,640,-9,30
5/8/2009,36,601,631,-30,-9
5/15/2009,-6,637,601,36,-30
5/22/2009,-8,631,637,-6,36
5/29/2009,-2,623,631,-8,-6
6/5/2009,-20,621,623,-2,-8
6/12/2009,7,601,621,-20,-2
6/19/2009,19,608,601,7,-20
6/26/2009,-13,627,608,19,7
7/3/2009,-49,614,627,-13,19
7/10/2009,-43,565,614,-49,-13
7/17/2009,32,522,565,-43,-49
7/24/2009,30,554,522,32,-43
7/31/2009,-34,584,554,30,32
8/7/2009,8,550,584,-34,30
8/14/2009,18,558,550,8,-34
8/21/2009,-6,576,558,18,8
8/28/2009,0,570,576,-6,18
9/4/2009,-20,570,570,0,-6
9/11/2009,-5,550,570,-20,0
9/18/2009,-15,545,550,-5,-20
9/25/2009,21,530,545,-15,-5
10/2/2009,-30,551,530,21,-15
10/9/2009,-7,521,551,-30,21
10/16/2009,17,514,521,-7,-30
10/23/2009,-1,531,514,17,-7
10/30/2009,-18,530,531,-1,17
11/6/2009,-10,512,530,-18,-1
11/13/2009,3,502,512,-10,-18
11/20/2009,-39,505,502,3,-10
11/27/2009,-9,466,505,-39,3
12/4/2009,17,457,466,-9,-39
12/11/2009,6,474,457,17,-9
12/18/2009,-28,480,474,6,17
12/25/2009,-20,452,480,-28,6
1/1/2010,2,432,452,-20,-28
1/8/2010,10,434,432,2,-20
1/15/2010,38,444,434,10,2
1/22/2010,-12,482,444,38,10
1/29/2010,10,470,482,-12,38
2/5/2010,-40,480,470,10,-12
2/12/2010,33,440,480,-40,10
2/19/2010,23,473,440,33,-40
2/26/2010,-27,496,473,23,33
3/5/2010,-7,469,496,-27,23
3/12/2010,-5,462,469,-7,-27
3/19/2010,-15,457,462,-5,-7
3/26/2010,-3,442,457,-15,-5
4/2/2010,21,439,442,-3,-15
4/9/2010,24,460,439,21,-3
4/16/2010,-28,484,460,24,21
4/23/2010,-8,456,484,-28,24
4/30/2010,-4,448,456,-8,-28
5/7/2010,0,444,448,-4,-8
5/14/2010,27,444,444,0,-4
5/21/2010,-11,471,444,27,0
5/28/2010,-7,460,471,-11,27
6/4/2010,3,453,460,-7,-11
6/11/2010,16,456,453,3,-7
6/18/2010,-15,472,456,16,3
6/25/2010,15,457,472,-15,16
7/2/2010,-18,472,457,15,-15
7/9/2010,-25,454,472,-18,15
7/16/2010,35,429,454,-25,-18
7/23/2010,-7,464,429,35,-25
7/30/2010,22,457,464,-7,35
8/6/2010,5,479,457,22,-7
8/13/2010,16,484,479,5,22
8/20/2010,-27,500,484,16,5
8/27/2010,-1,473,500,-27,16
9/3/2010,-21,472,473,-1,-27
9/10/2010,-1,451,472,-21,-1
9/17/2010,15,450,451,-1,-21
9/24/2010,-12,465,450,15,-1
10/1/2010,-8,453,465,-12,15
10/8/2010,17,445,453,-8,-12
10/15/2010,-10,462,445,17,-8
10/22/2010,-18,452,462,-10,17
10/29/2010,23,434,452,-18,-10
11/5/2010,-22,457,434,23,-18
11/12/2010,4,435,457,-22,23
11/19/2010,-32,439,435,4,-22
11/26/2010,29,407,439,-32,4
12/3/2010,-15,436,407,29,-32
12/10/2010,-1,421,436,-15,29
12/17/2010,0,420,421,-1,-15
12/24/2010,-32,420,420,0,-1
12/31/2010,21,388,420,-32,0
1/7/2011,36,409,388,21,-32
1/14/2011,-41,445,409,36,21
1/21/2011,50,404,445,-41,36
1/28/2011,-39,454,404,50,-41
2/4/2011,-32,415,454,-39,50
2/11/2011,27,383,415,-32,-39
2/18/2011,-19,410,383,27,-32
2/25/2011,-23,391,410,-19,27
3/4/2011,29,368,391,-23,-19
3/11/2011,-12,397,368,29,-23
3/18/2011,-3,385,397,-12,29
3/25/2011,6,382,385,-3,-12
4/1/2011,-6,388,382,6,-3
4/8/2011,30,382,388,-6,6
4/15/2011,-9,412,382,30,-6
4/22/2011,26,403,412,-9,30
4/29/2011,45,429,403,26,-9
5/6/2011,-40,474,429,45,26
5/13/2011,-25,434,474,-40,45
5/20/2011,15,409,434,-25,-40
5/27/2011,-2,424,409,15,-25
6/3/2011,5,422,424,-2,15
6/10/2011,-13,427,422,5,-2
6/17/2011,15,414,427,-13,5
6/24/2011,-1,429,414,15,-13
7/1/2011,-10,428,429,-1,15
7/8/2011,-13,418,428,-10,-1
7/15/2011,13,405,418,-13,-10
7/22/2011,-20,418,405,13,-13
7/29/2011,2,398,418,-20,13
8/5/2011,-5,400,398,2,-20
8/12/2011,13,395,400,-5,2
8/19/2011,9,408,395,13,-5
8/26/2011,-8,417,408,9,13
9/2/2011,5,409,417,-8,9
9/9/2011,14,414,409,5,-8
9/16/2011,-5,428,414,14,5
9/23/2011,-32,423,428,-5,14
9/30/2011,10,391,423,-32,-5
10/7/2011,3,401,391,10,-32
10/14/2011,-1,404,401,3,10
10/21/2011,-1,403,404,-1,3
10/28/2011,-5,402,403,-1,-1
11/4/2011,-7,397,402,-5,-1
11/11/2011,-2,390,397,-7,-5
11/18/2011,5,388,390,-2,-7
11/25/2011,9,393,388,5,-2
12/2/2011,-21,402,393,9,5
12/9/2011,-15,381,402,-21,9
12/16/2011,-2,366,381,-15,-21
12/23/2011,17,364,366,-2,-15
12/30/2011,-9,381,364,17,-2
1/6/2012,27,372,381,-9,17
1/13/2012,-47,399,372,27,-9
1/20/2012,25,352,399,-47,27
1/27/2012,-10,377,352,25,-47
2/3/2012,-9,367,377,-10,25
2/10/2012,-10,358,367,-9,-10
2/17/2012,3,348,358,-10,-9
2/24/2012,0,351,348,3,-10
3/2/2012,11,351,351,0,3
3/9/2012,-11,362,351,11,0
3/16/2012,-3,351,362,-11,11
3/23/2012,11,348,351,-3,-11
3/30/2012,-2,359,348,11,-3
4/6/2012,23,357,359,-2,11
4/13/2012,6,380,357,23,-2
4/20/2012,2,386,380,6,23
4/27/2012,-23,388,386,2,6
5/4/2012,2,365,388,-23,2
5/11/2012,3,367,365,2,-23
5/18/2012,0,370,367,3,2
5/25/2012,13,370,370,0,3
6/1/2012,-6,383,370,13,0
6/8/2012,9,377,383,-6,13
6/15/2012,1,386,377,9,-6
6/22/2012,-1,387,386,1,9
6/29/2012,-12,386,387,-1,1
7/6/2012,-24,374,386,-12,-1
7/13/2012,36,350,374,-24,-12
7/20/2012,-33,386,350,36,-24
7/27/2012,12,353,386,-33,36
8/3/2012,-4,365,353,12,-33
8/10/2012,5,361,365,-4,12
8/17/2012,6,366,361,5,-4
8/24/2012,2,372,366,6,5
8/31/2012,-9,374,372,2,6
9/7/2012,17,365,374,-9,2
9/14/2012,0,382,365,17,-9
9/21/2012,-23,382,382,0,17
9/28/2012,8,359,382,-23,0
10/5/2012,-28,367,359,8,-23
10/12/2012,49,339,367,-28,8
10/19/2012,-19,388,339,49,-28
10/26/2012,-6,369,388,-19,49
11/2/2012,-8,363,369,-6,-19
11/9/2012,84,355,363,-8,-6
11/16/2012,-29,439,355,84,-8
11/23/2012,-17,410,439,-29,84
11/30/2012,-23,393,410,-17,-29
12/7/2012,-27,370,393,-23,-17
12/14/2012,18,343,370,-27,-23
12/21/2012,-11,361,343,18,-27
12/28/2012,22,350,361,-11,18
1/4/2013,-1,372,350,22,-11
1/11/2013,-36,371,372,-1,22
1/18/2013,-5,335,371,-36,-1
1/25/2013,38,330,335,-5,-36
2/1/2013,-2,368,330,38,-5
2/8/2013,-25,366,368,-2,38
2/15/2013,21,341,366,-25,-2
2/22/2013,-18,362,341,21,-25
3/1/2013,-4,344,362,-18,21
3/8/2013,-8,340,344,-4,-18
3/15/2013,4,332,340,-8,-4
3/22/2013,21,336,332,4,-8
3/29/2013,28,357,336,21,4
4/5/2013,-39,385,357,28,21
4/12/2013,6,346,385,-39,28
4/19/2013,-13,352,346,6,-39
4/26/2013,-15,339,352,-13,6
5/3/2013,-1,324,339,-15,-13
5/10/2013,37,323,324,-1,-15
5/17/2013,-20,360,323,37,-1
5/24/2013,14,340,360,-20,37
5/31/2013,-8,354,340,14,-20
6/7/2013,-12,346,354,-8,14
6/14/2013,20,334,346,-12,-8
6/21/2013,-8,354,334,20,-12
6/28/2013,-3,346,354,-8,20
7/5/2013,17,343,346,-3,-8
7/12/2013,-26,360,343,17,-3
7/19/2013,9,334,360,-26,17
7/26/2013,-17,343,334,9,-26
8/2/2013,7,326,343,-17,9
8/9/2013,-13,333,326,7,-17
8/16/2013,16,320,333,-13,7
8/23/2013,-5,336,320,16,-13
8/30/2013,-8,331,336,-5,16
9/6/2013,-31,323,331,-8,-5
9/13/2013,17,292,323,-31,-8
9/20/2013,-4,309,292,17,-31
9/27/2013,3,305,309,-4,17
10/4/2013,66,308,305,3,-4
10/11/2013,-16,374,308,66,3
10/18/2013,-8,358,374,-16,66
10/25/2013,-10,350,358,-8,-16
11/1/2013,-4,340,350,-10,-8
11/8/2013,3,336,340,-4,-10
11/15/2013,-16,339,336,3,-4
11/22/2013,-7,323,339,-16,3
11/29/2013,-18,316,323,-7,-16
12/6/2013,70,298,316,-18,-7
12/13/2013,11,368,298,70,-18
12/20/2013,-41,379,368,11,70
12/27/2013,1,338,379,-41,11
1/3/2014,-9,339,338,1,-41
1/10/2014,-4,330,339,-9,1
1/17/2014,0,326,330,-4,-9
1/24/2014,22,326,326,0,-4
1/31/2014,-17,348,326,22,0
2/7/2014,8,331,348,-17,22
2/14/2014,-3,339,331,8,-17
2/21/2014,12,336,339,-3,8
2/28/2014,-25,348,336,12,-3
3/7/2014,-8,323,348,-25,12
3/14/2014,5,315,323,-8,-25
3/21/2014,-9,320,315,5,-8
3/28/2014,15,311,320,-9,5
4/4/2014,-26,326,311,15,-9
4/11/2014,4,300,326,-26,15
4/18/2014,25,304,300,4,-26
4/25/2014,15,329,304,25,4
5/2/2014,-25,344,329,15,25
5/9/2014,-22,319,344,-25,15
5/16/2014,29,297,319,-22,-25
5/23/2014,-26,326,297,29,-22
5/30/2014,12,300,326,-26,29
6/6/2014,5,312,300,12,-26
6/13/2014,-5,317,312,5,12
6/20/2014,0,312,317,-5,5
6/27/2014,3,312,312,0,-5
7/4/2014,-11,315,312,3,0
7/11/2014,-2,304,315,-11,3
7/18/2014,-18,302,304,-2,-11
7/25/2014,18,284,302,-18,-2
8/1/2014,-13,302,284,18,-18
8/8/2014,22,289,302,-13,18
8/15/2014,-13,311,289,22,-13
8/22/2014,0,298,311,-13,22
8/29/2014,4,298,298,0,-13
9/5/2014,13,302,298,4,0
9/12/2014,-35,315,302,13,4
9/19/2014,13,280,315,-35,13
9/26/2014,-6,293,280,13,-35
10/3/2014,0,287,293,-6,13
10/10/2014,-23,287,287,0,-6
10/17/2014,19,264,287,-23,0
10/24/2014,4,283,264,19,-23
