candidate,MonthId,Label,OneMonthBefore,NumTweets_FullMonth,NormalizedNumTweets_FullMonth,NumTweetsText_FullMonth,NormalizedNumTweetsText_FullMonth,NumTweetsTitle_FullMonth,NormalizedNumTweetsTitle_FullMonth,NumTweetsVerified_FullMonth,NormalizedNumTweetsVerified_FullMonth,NumTweets_HalfMonth,NormalizedNumTweets_HalfMonth,NumTweetsText_HalfMonth,NormalizedNumTweetsText_HalfMonth,NumTweetsTitle_HalfMonth,NormalizedNumTweetsTitle_HalfMonth,NumTweetsVerified_HalfMonth,NormalizedNumTweetsVerified_HalfMonth,NumTweets_LastWeek,NormalizedNumTweets_LastWeek,NumTweetsText_LastWeek,NormalizedNumTweetsText_LastWeek,NumTweetsTitle_LastWeek,NormalizedNumTweetsTitle_LastWeek,NumTweetsVerified_LastWeek,NormalizedNumTweetsVerified_LastWeek
job posting,201201,133188,132828,865963,1.726205355,794358,1.583468386,71605,0.14273697,2458,0.004899762,580859,2.139971927,538363,1.983410271,42496,0.156561656,2173,0.008005659,201850,1.478191458,178577,1.307758217,23273,0.170433242,1270,0.009300486
job posting,201202,133414,133188,675346,1.257585407,556768,1.036777166,118578,0.220808241,1914,0.003564126,315383,1.174615175,260398,0.969828565,54985,0.20478661,1150,0.00428307,87546,0.76189896,64640,0.562551673,22906,0.199347287,379,0.003298377
job posting,201203,133657,133414,2692925,4.326477397,2588765,4.15913301,104160,0.167344388,1983,0.003185906,2337207,7.156964638,2278387,6.976846805,58820,0.180117833,1083,0.003316348,1879137,11.31873871,1855847,11.1784544,23290,0.140284303,508,0.003059872
job posting,201204,133753,133657,950284,1.363982673,730671,1.048762879,219613,0.315219794,2455,0.003523765,334587,0.935889367,213813,0.598066611,120774,0.337822756,1174,0.003283852,141818,0.825209331,101438,0.590246542,40380,0.234962789,594,0.003456362
job posting,201205,133863,133753,1755401,2.294716821,1354892,1.771158535,400509,0.523558286,2765,0.003614497,1207712,2.992786359,1117557,2.769376594,90155,0.223409765,837,0.002074139,565629,2.7413936,520915,2.524681455,44714,0.216712144,319,0.001546074
job posting,201206,133951,133863,592252,0.647107992,405051,0.442567926,187201,0.204540066,1693,0.00184981,249926,0.531284942,148261,0.315168637,101665,0.216116305,1048,0.002227806,109086,0.50573487,67018,0.310702927,42068,0.195031943,417,0.001933259
job posting,201207,134111,133951,2687716,2.503251404,1461457,1.361153592,1226259,1.142097812,2081,0.001938176,2311437,4.037656122,1184622,2.069317169,1126815,1.968338952,1160,0.002026307,145293,0.497025571,77327,0.264524074,67966,0.232501497,792,0.002709313
job posting,201208,134261,134111,549200,0.461190159,420526,0.353136295,128674,0.108053865,3596,0.003019737,248568,0.400766165,166914,0.269115428,81654,0.131650737,1852,0.002985979,131099,0.423918773,85164,0.275384392,45935,0.148534381,801,0.002590096
job posting,201209,134422,134261,2929389,2.369400215,2672972,2.162000482,256417,0.207399732,5506,0.00445346,298486,0.473276463,174387,0.276506311,124099,0.196770153,1518,0.002406926,140152,0.478075038,81040,0.276437019,59112,0.201638019,810,0.002763006
job posting,201210,134647,134422,2062999,1.453730409,1695106,1.194487801,367893,0.259242608,5749,0.004051139,634995,0.832818556,516615,0.67755897,118380,0.155259586,3325,0.004360856,268645,0.689361844,216410,0.555323184,52235,0.13403866,727,0.001865533
job posting,201211,134850,134647,1139109,0.523227421,938604,0.431129374,200505,0.092098047,3065,0.001407848,281695,0.227323347,186575,0.150563033,95120,0.076760314,1199,0.000967574,146184,0.233862969,98570,0.157690806,47614,0.076172162,713,0.001140647
job posting,201212,135064,134850,378413,0.01389988,217953,0.008005857,160460,0.005894022,3099,0.000113833,143025,0.00559599,73900,0.002891408,69125,0.002704582,1088,4.26E-05,58997,0.002419514,28855,0.001183367,30142,0.001236147,595,2.44E-05
job posting,201301,135261,135064,506114,0.000294334,274623,0.000159709,231491,0.000134625,4147,2.41E-06,240540,0.000270839,130140,0.000146533,110400,0.000124306,2493,2.81E-06,110636,0.000251175,63175,0.000143425,47461,0.00010775,1237,2.81E-06
job posting,201302,135541,135261,418655,0.000269,243893,0.00015671,174762,0.000112291,10334,6.64E-06,203491,0.000282496,121140,0.000168172,82351,0.000114324,3446,4.78E-06,89924,0.000324514,58302,0.000210398,31622,0.000114116,949,3.42E-06
job posting,201303,135682,135541,400444,0.000243051,255717,0.000155208,144727,8.78E-05,3973,2.41E-06,186543,0.000222493,117275,0.000139876,69268,8.26E-05,1720,2.05E-06,80430,0.000196962,47694,0.000116796,32736,8.02E-05,1000,2.45E-06
job posting,201304,135885,135682,421733,0.000243878,255167,0.000147557,166566,9.63E-05,4015,2.32E-06,222343,0.00024991,136406,0.000153318,85937,9.66E-05,2000,2.25E-06,98437,0.00024205,61796,0.000151952,36641,9.01E-05,1211,2.98E-06
job posting,201305,136084,135885,456539,0.000246296,282453,0.000152379,174086,9.39E-05,5444,2.94E-06,233418,0.000244551,145938,0.000152898,87480,9.17E-05,2286,2.40E-06,116536,0.000243282,71564,0.000149398,44972,9.39E-05,1108,2.31E-06
job posting,201306,136285,136084,369638,0.000208959,258097,0.000145904,111541,6.31E-05,5083,2.87E-06,166524,0.000188456,122652,0.000138806,43872,4.97E-05,2970,3.36E-06,81994,0.00019824,60042,0.000145166,21952,5.31E-05,1829,4.42E-06
job posting,201307,136434,136285,382539,0.000207738,282957,0.00015366,99582,5.41E-05,6052,3.29E-06,206877,0.000214695,151098,0.000156808,55779,5.79E-05,3604,3.74E-06,109002,0.000226031,80786,0.000167521,28216,5.85E-05,2002,4.15E-06
job posting,201308,136636,136434,412263,0.000219752,314727,0.000167762,97536,5.20E-05,8356,4.45E-06,214241,0.000221167,161988,0.000167225,52253,5.39E-05,4568,4.72E-06,95679,0.000197686,70947,0.000146586,24732,5.11E-05,2100,4.34E-06
job posting,201309,136800,136636,414195,0.000231587,297096,0.000166114,117099,6.55E-05,11822,6.61E-06,209083,0.00023961,148533,0.000170219,60550,6.94E-05,5798,6.64E-06,90090,0.000228376,63288,0.000160434,26802,6.79E-05,2041,5.17E-06
job posting,201310,137037,136800,358201,0.000238386,248299,0.000165245,109902,7.31E-05,9434,6.28E-06,189228,0.000244788,133689,0.000172942,55539,7.18E-05,4858,6.28E-06,93500,0.00024151,65970,0.0001704,27530,7.11E-05,2330,6.02E-06
job posting,201311,137311,137037,401629,0.000280779,315139,0.000220314,86490,6.05E-05,9192,6.43E-06,193683,0.000270932,150720,0.000210833,42963,6.01E-05,4285,5.99E-06,81349,0.000242145,62983,0.000187476,18366,5.47E-05,1220,3.63E-06
job posting,201312,137395,137311,380686,0.000262257,299162,0.000206094,81524,5.62E-05,8022,5.53E-06,176646,0.000237245,137979,0.000185313,38667,5.19E-05,3754,5.04E-06,76216,0.000201945,59666,0.000158093,16550,4.39E-05,1660,4.40E-06
job posting,201401,137539,137395,437578,0.000295352,328232,0.000221546,109346,7.38E-05,13105,8.85E-06,213377,0.000277884,156776,0.000204172,56601,7.37E-05,6612,8.61E-06,105536,0.000274576,78307,0.000203733,27229,7.08E-05,2615,6.80E-06
job posting,201402,137761,137539,381882,0.000294964,290330,0.00022425,91552,7.07E-05,11983,9.26E-06,189987,0.000322114,143268,0.000242904,46719,7.92E-05,6379,1.08E-05,78230,0.000348497,59187,0.000263665,19043,8.48E-05,2221,9.89E-06
job posting,201403,137964,137761,512538,0.00036511,364485,0.000259643,148053,0.000105467,12035,8.57E-06,282918,0.000388317,189436,0.000260009,93482,0.000128308,6765,9.29E-06,143214,0.000395312,95897,0.000264703,47317,0.000130609,3785,1.04E-05
job posting,201404,138268,137964,503087,0.000380429,343919,0.000260068,159168,0.000120361,13063,9.88E-06,246823,0.000371471,169442,0.000255012,77381,0.000116459,6092,9.17E-06,116201,0.000376478,80304,0.000260176,35897,0.000116302,2251,7.29E-06
job posting,201405,138492,138268,522077,0.000393707,360930,0.000272183,161147,0.000121524,14950,1.13E-05,268118,0.000393903,187602,0.000275614,80516,0.000118289,8532,1.25E-05,125254,0.000365619,85807,0.000250472,39447,0.000115147,4692,1.37E-05
job posting,201406,138780,138492,608041,0.000358078,424324,0.000249886,183717,0.000108192,15143,8.92E-06,299463,0.000357308,204100,0.000243525,95363,0.000113784,7017,8.37E-06,137542,0.000361469,92549,0.000243224,44993,0.000118244,3036,7.98E-06
